really=reely
god/could=cod
kill=krill
pwn/pawn=prawn
something=somefin
nothing=nofin
whatever=waterever
sardonic=sardinonic
feeling=eeling
hero=heroe
heroine=heroeine
row=roe
routine=roetine
opportunity=opportunaty
purchase=perchase
well=whale
welcome=whalecome
hilarious=gillarious
illegal=gillegal
debate=debait
doofus=doofish
meant=manta
slammin/summon=salmon
creative=crayative
creature=crayture
had=haddock
mack=mackerel
outrageous=outraygeous
cuddle=cuttle
hullabaloo=hullabeluga
pick/like=pike
couldn’t=codn’t
purpose/prepose/propose=porpoise
coy=koi
hate=hake
brilliant=krilliant
crappy=crappie
hearing=herring
bet/better=betta
selfish=shellfish
fantastic=fintastic
fantasy=fintasy
fun/fan/fine/find=fin
hell of it=halibut
lotsa=lobsta
observations=lobstervations
fumbling=floundering
believe=bereef
practicing=pracfishing
enemy/any=anemone
body=moby
sealed=sea eeled
inaccurate=finaccurate
important=finportant
simple=shrimple
simply=shrimply
self=shellf
me know=minnow
asshole=basshole
pawn/pwn=prawn
definitely=dolphinitely
elated=eelated
con=conch
amscray=clamscray
more=moray
moray-eel=moireel
moirail=morayrail
kismesis=fishmesis
auspistice=ausfishtice
snap=snapper
wailing=whaling
special=speshell
sell/hell=shell
muscle=mussel
go be=goby
help=kelp
girl=gill
friend/fond=frond
flipping=flippering
kidding=squidding
sure=shore
moola=mola
see=sea
weapon=weaprawn
appear=appier
disappear=disappier
each/bitch=beach
specific=pacific
surgeon=sturgeon
what are=water
always=alwaves
attitude=attitide
accquianted=aquainted
serious=searious
secret=seacret
seen=sean
not=naut
naughty=nauty
actually=actshoally
tidy=tidey
totally=tidally
sanitary=sanditary
gullible=seagullible
puffing=puffin
craysea=crazy
turn=tern
lunasea=lunacy
otherwise=otterwise
other/oughta/outta=otter
asshole=asshoal
shirk/stark=shark
tone of/tune=tuna
boy=buoy
about=aboat
bout=boat
jealous=jellyfish
what about=waterboat
kill=keel
hell/haul=hull
sooner=schooner
sell=sail
huge/big/grand/massive/etc=titanic
shut up=clam up
out the ass=out the blowhole
left=port
right=starboard
back=stern
front=bow
talking/chatting=carping
leader=captain
sweetheart/darling=angelfish
